1111111111
1H00100001
1000100001
1000100101
1011100101
1000000101
1111111101
1000000001
100E000001
1001001001
1001001111
1001000001
1001001001
1001001$01
1111111111
